NYYYNYYYN
NNYYNYYNN
YNNNYNNNY
YYYYYYYYY
NNNYNYNNN
NNYYNYYYN